E.............E
.#.#..###..#.#.
.#.#..###..#.#.
.#.#.......#.#.
...............
......#.#......
.#.#..###..#.#.
.#.#..#.#..#.#.
..............P
